600000000 : 0
600000001 : 1
600000002 : 2
600000003 : 3
600000004 : 4